####################
#........##........#
#...#....##.@...#..#
#........##........#
####################
.....................