...............
..###.....###..
.##.##...##.##.
##...##.##...##
#.....###.....#
#.............#
#......@......#
#.............#
##...........##
.##.........##.
..##.......##..
...##.....##...
....##...##....
.....#####.....
......###......