....########....
..##........##..
.#...#....#...#.
#......@.......#
#..#........#..#
.#..########..#
..#..........#..
...##########...
................